1
ZZZZZZZZZZZZZZZZZZZZZZZZZZZZZZZZZZZZZZZZZZZZZZZZZZZZZZZZZZZZ

ZZZZZZZZZZZZZZZZZZZZZZZZZZZZZZZZZZZZZZZZZZZZZZZZZZZZZZZZZZZZ

ZZZZZZZZZZZZZZZZZZZZZZZZZZZZZZZZZZZZZZZZZZZZZZZZZZZZZZZZZZZZ

ZZZZZZZZZZZZZZZZZZZZZZZZZZZZZZZZZZZZZZZZZZZZZZZZZZZZZZZZZZZZ

ZZZZZZZZZZZZZZZZZZZZZZZZZZZZZZZZZZZZZZZZZZZZZZZZZZZZZZZZZZZZ

ZZZZZZZZZZZZZZZZZZZZZZZZZZZZZZZZZZZZZZZZZZZZZZZZZZZZZZZZZZZZ

ZZZZZZZZZZZZZZZZZZZZZZZZZZZZZZZZZZZZZZZZZZZZZZZZZZZZZZZZZZZZ

B1B2B3ZZZZZZZZZZZZZZZZZZZZZZZZZZZZZZZZZZZZZZZZZZZZZZZZZZZZZZ

C1C2C3ZZZZZZZZZZZZZZZZZZZZZZZZZZZZZZZZZZZZZZZZZZZZZZZZZZZZZZ

D1D1C3ZZZZZZZZZZZZZZZZZZZZZZZZZZZZZZZZZZZZZZZZZZZZZZB0B2B1B2

C2D0C3ZZZZZZZZZZZZZZZZZZZZZZZZZZZZZZZZZZZZZZZZZZZZZZC0C1C2C1

D1D1C3ZZZZZZZZZZZZZZZZZZZZZZZZZZZZZZZZZZZZZZZZZZZZZZC0C1D0D1

C2D0C6B1B2B1B2B1B2B1B2B3ZZZZZZB0Q2Q3P2Q0Q1B1B2B1B2B1C5C2D1D0

C1D1D0D1C1C2C1D0C1C2C1V2W0X0Y0V7V2W0X0Y0V7C1C2C1C2C1C2C1D0D1

C2C1D1D0D1D0D1D0C2D0C2V2W1X1Y1V7V2W1X1Y1V7C2D0D1D0D1D0C1D1D0

D2C2D2D1C1D2D2D0D2D1C1V2W2X2Y2V7V2W2X2Y2V7C1D1D2D2D2D0D2D0D0

ZZZZZZZZZZZZZZZZZZZZZZZZZZZZZZZZZZZZZZZZZZZZZZZZZZZZZZZZZZZZ
100/350
0

0

1
1200/680/
0

0

3
tree/300/390/+tuto/750/230/+bush/230/680/
000/
1710/410/
 /