1
ZZZZZZZZZZZZZZZZZZZZZZZZZZZZZZZZZZZZZZZZZZZZZZZZZZZZZZZZZZZZ

ZZZZZZZZZZZZZZZZZZZZZZZZZZZZZZZZZZZZZZZZZZZZZZZZZZZZZZZZZZZZ

B3ZZZZZZZZZZZZZZZZZZZZZZZZZZZZZZZZZZZZZZZZZZZZZZZZZZZZZZZZZZ

C6B1B3ZZZZZZZZZZZZZZZZZZZZZZZZZZB4ZZZZZZZZZZZZZZZZZZZZZZZZZZ

C1C8E2A2A3ZZZZZZZZZZZZZZZZZZB0B2C3ZZZZZZZZZZZZZZZZZZZZZZZZZZ

C2C3ZZZZZZZZZZZZZZZZZZS3ZZZZC0C1C6B3ZZZZZZZZZZZZZZZZZZZZZZZZ

C1E3ZZZZZZZZZZZZZZB0B1R3ZZZZC0C1C2C6A3ZZZZZZZZZZZZZZZZZZZZZZ

C3ZZZZZZZZZZZZB0B1E6C7C3ZZS0C0C2C1C3ZZZZZZZZZZZZZZZZZZZZZZZZ

C3S1ZZZZZZZZA0C5E8F1C0C3ZZRAC5C7C8E8ZZZZZZZZZZZZZZZZZZZZZZZZ

E1RBA3ZZZZZZZZC4F2D3E5C3ZZF0E5C7C3F3ZZZZZZZZZZZZZZZZZZZZZZZZ

ZZZZZZZZZZZZS1C4F1D3D4C4ZZG0F7E5E8F3ZZZZZZZZZZZZZZZZZZZZZZZZ

ZZZZZZZZZZB0R1C3F2D3D4C4ZZZZF0F1F8G3ZZZZZZZZZZZZZZZZZZZZZZZZ

ZZZZZZZZZZC0C8E8F1B4D3C4S3ZZG0F7F3ZZZZB0Q6Q3P3ZZZZZZZZP0Q0Q1

B1B2B3ZZZZC0C3D4F7C4F2E5R3ZZZZF0F3ZZZZC4ZZZZZZZZZZZZZZZZZZC0

C1C2V0W0Y0V5C3D3A0E8D4F2C0B1B2B6B7B1B2C3W0X0X0X0X0X0X0X0Y0V5

D1C1V1W1Y1V6C3F2D4D3D4F2C0C1C2D1D0C2C1C3W1X1X1X1X1X1X1X1Y1V6

ZZZZZZZZZZZZZZZZZZZZZZZZZZZZZZZZZZZZZZZZZZZZZZZZZZZZZZZZZZZZ
100/700
0

0

0

0

0

0

13/
1720/600/
qzdqzdzzzqzd/