1
ZZZZZZZZZZZZZZZZZZZZZZZZZZZZZZZZZZZZZZZZZZZZZZZZZZZZZZZZZZZZ

ZZZZZZZZZZZZZZZZZZZZZZZZZZZZZZZZZZZZZZZZZZZZZZZZZZZZZZZZZZZZ

ZZZZZZZZZZZZZZZZZZZZZZZZZZZZZZZZZZZZZZZZZZZZZZZZZZZZZZZZZZZZ

ZZZZZZZZZZZZZZZZZZZZZZZZZZZZZZZZZZZZZZZZZZZZZZZZZZZZZZZZZZZZ

ZZZZZZZZZZZZZZZZZZZZZZZZZZZZZZZZZZZZZZZZZZB0B1B2B1A3ZZZZZZZZ

ZZZZZZZZZZZZB0B3ZZZZZZZZZZZZZZZZZZZZZZZZZZC0C1C8E3ZZZZZZZZZZ

ZZZZZZZZZZZZE0E3ZZZZZZZZZZZZZZZZZZZZZZZZB0C5C8E3ZZZZZZZZZZZZ

ZZZZZZZZZZZZZZZZZZZZZZZZZZZZZZZZZZZZZZB0C5C8E3ZZZZZZZZZZZZZZ

A2A3ZZZZZZZZZZZZZZZZZZZZZZZZZZZZS0B0B2C5C8E3ZZZZZZZZZZZZZZZZ

F1F3ZZZZZZZZZZZZZZZZZZZZZZZZZZS0R0C5C8E6E3ZZZZZZZZZZZZZZZZZZ

F2F3ZZB0B3ZZZZZZZZZZZZZZZZZZZZR0C5C8E8F3ZZZZZZZZZZZZZZZZZZZZ

B6B7B1C5C6B2B1B2B3ZZZZZZZZZZZZC0C8E8F8G3ZZZZZZZZZZZZZZZZZZZZ

C1C2C8E6E7C7C1C2C3ZZZZZZZZZZS0C0C3F2F3ZZZZZZZZZZZZZZZZZZZZZZ

D0C8E8F1F2E5C7C2C3ZZZZZZZZZZR0C5C6B7B6B3ZZZZZZZZZZZZZZZZZZZZ

D1C3D4D3F1D3E5C7V0W0X0X0X0Y0V5C1C2C1D0V0W0X0X0X0X0X0X0X0X0Y0

C1C3F2D3D4F2F1C0V1W1X1X1X1Y1V6D0D1D2C2V1W1X1X1X1X1X1X1X1X1Y1

ZZZZZZZZZZZZZZZZZZZZZZZZZZZZZZZZZZZZZZZZZZZZZZZZZZZZZZZZZZZZ
100/600
1
1408/240/1350/1600/
1
210/600/2000/707/448/128/48/P1/
2
400/600/+410/180/
0

2
1300/800/128/1700/0/P1/+200/200/128/500/1/P1/
1
tronc/1500/205/
333/
1130/660/
 /