1
ZZZZZZZZZZZZZZZZZZZZZZZZZZZZZZZZZZZZZZZZZZZZZZZZZZZZZZZZZZZZ

ZZZZZZZZZZZZZZZZZZZZZZZZZZZZZZZZZZZZZZZZZZZZZZZZZZZZZZZZZZZZ

ZZZZZZZZZZZZZZZZZZZZZZZZZZZZZZZZZZZZZZZZZZZZZZZZZZZZZZZZZZZZ

ZZZZZZZZZZZZZZZZZZZZZZZZZZZZZZZZZZZZZZZZZZA0A1A3ZZZZZZZZZZZZ

ZZZZZZZZZZZZB4ZZZZZZZZZZZZZZZZZZZZZZZZZZZZZZZZZZZZZZZZZZZZZZ

ZZZZZZZZZZZZCEB2B1B2B1B2B3ZZZZZZZZZZZZZZZZZZZZZZZZZZZZZZZZZZ

ZZZZZZZZZZZZC0C8E6E7E6E7E3ZZZZZZZZZZZZZZZZZZZZZZZZZZZZZZZZZZ

B1CBA1A3ZZZZE0E3F7F2D3F1F3ZZZZZZZZZZZZZZZZZZZZZZZZZZZZZZZZZZ

C2C3F8G3ZZZZZZZZG0F7D3D4F3ZZZZZZZZZZZZB4ZZZZZZZZZZZZZZZZZZZZ

C1C3G3ZZZZZZZZZZZZG0F7F8G3ZZZZZZZZZZZZC4ZZZZZZZZZZZZZZZZZZZZ

C2C3S1ZZZZZZZZZZZZZZF0F3ZZZZZZZZZZZZZZCEB3ZZZZZZZZZZZZZZZZZZ

C1C6R1B3ZZZZZZP0Q0Q1B1B2Q2Q7Q4Q1B1B2B1C5C6B3ZZZZZZZZZZZZZZZZ

C2C1C8E3ZZZZZZZZZZC0C1C2C3ZZZZC0C1C2D0D1C2C3ZZZZZZZZZZZZZZZZ

D1D0C3ZZZZZZZZZZZZC0D0D1C3ZZZZC0C2D1D2D2D1C6B1B3ZZZZZZZZZZZZ

C2D0V0W0X0X0X0X0Y0V5D1D0V0W0Y0V5C1D0D1D2D1C1C2V0W0X0X0X0X0Y0

D2D1V1W1X1X1X1X1Y1V6D2D2V1W1Y1V6C2D2D2D1D0D1C1V1W1X1X1X1X1Y1

ZZZZZZZZZZZZZZZZZZZZZZZZZZZZZZZZZZZZZZZZZZZZZZZZZZZZZZZZZZZZ
50/350
0

0

0

1
650/335/6/L3/
2
1600/100/128/800/1/P1/+3000/100/128/800/0/P1/
2
choptronc/1000/650/+stoneA/460/270/
222/
1350/30/
 /