1
ZZZZZZZZZZZZZZZZZZZZZZZZZZZZZZZZZZZZZZZZZZZZZZZZZZZZZZZZZZZZ

ZZZZZZZZZZZZZZZZZZZZZZZZZZZZZZZZZZZZZZZZZZZZZZZZZZZZZZZZZZZZ

ZZZZZZZZZZZZZZZZZZZZZZZZZZZZZZZZZZZZZZZZZZZZZZZZZZZZZZZZZZB0

ZZZZZZZZZZZZZZZZZZZZZZZZZZZZZZZZZZZZZZZZZZZZZZZZZZZZZZB0B1C5

ZZZZZZZZZZZZZZZZZZZZZZZZZZZZZZZZZZZZZZZZZZZZZZZZZZZZZZC0C1C2

ZZZZZZZZZZZZZZB0B3ZZZZZZZZZZZZZZZZZZZZZZZZZZP0P1Q4Q5A1E7C2C1

ZZZZZZZZZZZZZZE0C6B1B1B2B3ZZZZZZZZZZZZZZZZZZZZZZZZZZG0F7E5C1

ZZZZZZZZZZZZZZZZC0C1C2C8E2A2A3ZZZZZZA4ZZZZZZZZZZZZZZZZF0F1C0

ZZZZZZZZZZZZZZZZE0E6E7E8ZZZZZZZZZZZZZZZZZZZZZZZZZZZZZZG0F7C0

ZZZZZZZZZZZZZZZZZZG0F7F3ZZZZZZZZZZZZZZZZZZZZZZZZZZZZZZZZF0C0

B0B3ZZZZZZZZZZZZZZZZG0G3ZZZZZZZZZZZZZZZZZZS4ZZZZZZZZZZB0B2C5

C1C6B3ZZZZS1ZZZZZZS1ZZZZZZS1ZZZZB0B1B2A3ZZRGZZB0B1B2B1C5C2C2

C2D1C6A1A2RBB2B1B2R1B1B2B1R3ZZZZC0C1C3ZZZZZZZZE5C1C2C1C1C2C1

C1C8E8F8G1F7E5E6E7E7C7C2C8E3ZZZZC0C8V0W0X0X0X0Y0V5C1C2C1C1D0

E5E8F2F3ZZF0F1F8G3ZZE0C7C3ZZZZZZC0C1V1W1X1X1X1Y1V6C7D2D2D1D1

ZZG0G1G3ZZF0F2F3ZZZZZZC0C3ZZZZZZC0C2V2W2X2X2X2Y2V7C2C1C2C2D2

ZZZZZZZZZZZZZZZZZZZZZZZZZZZZZZZZZZZZZZZZZZZZZZZZZZZZZZZZZZZZ
600/150
0

1
70/600/3000/900/770/128/48/P1/
0

1
1600/360/6/L3/
0

0

777/
640/220/
 /
