1
ZZZZZZZZZZZZZZZZZZZZZZZZZZZZZZZZZZZZZZZZZZZZZZZZZZZZZZZZZZZZ

ZZZZZZZZZZZZZZZZZZZZZZZZZZZZZZZZZZZZZZZZZZZZZZZZZZZZZZZZZZZZ

ZZZZZZZZZZZZZZZZZZZZZZZZZZZZZZZZZZZZZZZZZZZZZZZZZZZZZZZZZZZZ

ZZZZZZZZZZZZZZZZB0B1B2B3ZZZZZZZZZZZZZZZZZZZZZZZZZZZZZZZZZZZZ

ZZZZZZZZZZZZZZB0C5C8E1E3ZZZZZZZZZZZZZZZZZZZZZZZZZZZZZZZZZZZZ

ZZZZZZZZZZZZZZC0C8E3ZZZZZZZZZZZZZZZZZZZZZZZZZZZZZZZZZZZZZZZZ

B1B2B1B3ZZZZZZE0E3ZZZZZZZZZZZZZZZZZZZZZZZZZZZZZZZZZZZZZZZZB0

C1C2C8E3ZZZZZZZZZZZZZZZZZZZZZZZZZZZZZZZZZZZZZZZZB0B1B2B1B2C5

C2C8E3ZZZZZZZZZZZZZZZZZZZZZZZZZZZZZZZZZZZZZZB0B1C5C1C2C1C2D0

C1C3ZZZZZZZZZZZZZZZZZZZZZZB4ZZZZZZZZZZZZZZZZC0C1D0D1C8E6C1D2

D1C3ZZZZZZZZZZZZZZZZZZB0B1CIQ6Q7P1P2P1P2Q0Q5E1C2D0D1C3F1C0C1

D0C6A1B1B2B1B2B1B2B1B2C5C3ZZZZZZZZZZZZZZZZZZZZC0C1D0C3F2F1C0

C1C3F1E5E6C7C1C2D1D0C2C1V0W0X0X0X0X0X0X0X0X0Y0V5C8E6E7B6B7C5

D0E8D3D4F2C0C8E6C7C1C2C1V1W1X1X1X1X1X1X1X1X1Y1V6C3D4D3E5C7D1

C3F1D4D3B5C1C3D3E5C7D2D0V2W2X2X2X2X2X2X2X2X2Y2V7C3F1D4F2C0D0

C3F2D3D4C0C2C3D4D3C0D1D0V3W3X3X3X3X3X3X3X3X3Y3V8C6B3F2D3C0C1

ZZZZZZZZZZZZZZZZZZZZZZZZZZZZZZZZZZZZZZZZZZZZZZZZZZZZZZZZZZZZ
100/100
7
120/690/120/615/+300/690/120/615/+400/690/120/615/+550/690/120/615/+900/630/900/1320/+1100/630/900/1320/+1200/630/900/1320/
0

0

0

0

0

14/
1800/220/
 /