1
ZZZZZZZZZZZZZZZZZZZZZZZZZZZZZZZZZZZZZZZZZZZZZZZZZZZZZZZZZZZZ

ZZZZZZZZZZZZZZZZZZZZZZZZZZZZZZZZZZZZZZZZZZZZZZZZZZZZZZZZZZZZ

ZZZZZZZZZZZZZZZZZZZZZZZZZZZZZZZZZZZZZZZZZZZZZZZZZZZZZZZZZZZZ

ZZZZZZZZZZZZZZZZZZZZZZZZZZZZZZZZZZZZZZZZZZZZZZZZZZZZZZZZZZZZ

ZZZZZZZZZZZZZZZZZZZZZZZZZZZZZZZZA0A1A2A3ZZZZZZZZZZZZZZZZZZZZ

ZZZZZZZZZZZZZZZZZZB0B3ZZZZZZZZZZZZZZZZZZZZZZZZZZZZZZZZZZZZZZ

ZZZZZZZZZZZZZZZZB0C5E3ZZZZZZZZZZZZZZZZZZZZZZZZZZZZZZZZZZZZZZ

ZZZZZZZZB0B1B2B1C5E3ZZZZZZZZZZZZZZZZZZZZZZZZZZZZZZZZZZZZZZZZ

ZZZZZZZZE0E1E2E1E3ZZZZZZZZZZZZZZZZZZZZZZZZZZZZZZZZZZP4P1Q0Q1

ZZZZZZZZZZZZZZZZZZZZZZZZZZZZZZZZZZZZZZZZZZZZZZZZZZZZZZZZZZZZ

ZZZZZZZZZZZZZZZZZZZZZZZZZZZZZZZZZZZZZZZZZZZZZZZZZZZZZZZZZZZZ

ZZZZZZZZZZZZZZZZZZZZZZZZZZZZZZZZZZZZZZZZZZZZZZZZZZZZZZZZZZZZ

B2B3ZZZZZZZZZZZZZZZZZZZZZZZZZZZZC0E3ZZZZZZZZZZZZZZZZZZZZZZZZ

C1C2ZZZZZZZZZZZZZZZZZZZZZZZZZZZZC4ZZZZZZZZZZZZZZZZZZZZZZZZZZ

C2V0W0X0X0X0X0X0X0X0X0X0X0X0X0Y0U0ZZZZZZZZZZZZZZZZZZZZZZZZZZ

C1V1W1X1X1X1X1X1X1X1X1X1X1X1X1Y1U1ZZZZZZZZZZZZZZZZZZZZZZZZZZ

ZZZZZZZZZZZZZZZZZZZZZZZZZZZZZZZZZZZZZZZZZZZZZZZZZZZZZZZZZZZZ
100/700
0

2
1150/740/5000/1400/600/200/48/P1/+1730/470/5000/1090/550/200/48/P1/
0

0

2
256/870/200/700/0/P1/+512/675/200/960/1/P1/
1
tree/320/405/
12/
1150/200/
dhgkdjskl/
