1
ZZZZZZZZZZZZZZZZZZZZZZZZZZZZZZZZZZZZZZZZZZZZZZZZZZZZZZZZZZZZ

ZZZZZZZZZZZZZZZZZZZZZZZZZZZZZZZZZZZZZZZZZZZZZZZZZZZZZZZZZZZZ

ZZZZZZZZZZZZZZZZZZZZZZZZZZZZZZZZZZZZZZZZZZZZZZZZZZZZZZZZZZZZ

ZZZZZZZZZZB0B3ZZZZZZZZZZZZZZZZZZZZZZZZZZZZZZZZZZZZZZZZZZZZZZ

ZZZZZZZZZZC0C3ZZZZZZA0C1B1CBA3ZZZZZZZZZZZZZZZZZZZZZZZZZZZZZZ

ZZZZZZZZB0C5C3ZZZZZZG0E0C9E3ZZZZZZZZZZZZZZZZZZZZZZZZZZZZZZZZ

ZZZZZZB0C5E1E3ZZZZZZZZG0E4ZZZZZZZZZZZZZZZZZZZZZZZZZZZZZZZZZZ

ZZZZZZE0E3ZZZZZZZZZZZZZZZZZZZZZZZZZZZZZZZZZZZZZZZZZZZZZZZZZZ

ZZZZZZZZZZZZZZZZZZS3ZZZZZZA0A1A2Q6ZZZZZZZZZZZZZZZZZZZZZZZZZZ

ZZZZZZZZZZZZZZZZA0RDZZZZZZZZZZZZZZZZZZZZZZZZZZZZZZZZZZZZZZZZ

B2B3ZZZZZZZZZZZZZZZZZZZZZZZZZZZZZZA0A1A2CAB3ZZZZZZZZZZZZZZZZ

C2C3S0S3B0B3ZZZZZZZZZZZZZZZZZZZZZZG0D3F1C0C6A3ZZZZZZZZZZZZZZ

D0C6R4R5C5E3ZZZZZZZZZZZZB0B3ZZZZZZZZF0F2C0C3ZZZZZZZZA0B1B2B1

D1C2C1C3ZZZZZZZZZZZZZZZZC0C3ZZB0B3ZZF0B5C5C3ZZZZZZZZZZC0C1D0

D2D1D0V0W0X0X0X0X0X0X0Y0V5C6B1C5C6B1B7C5C2V0W0X0X0X0Y0V5C2D1

D2D2D1V1W1X1X1X1X1X1X1Y1V6D0D1D2D1D2D2D1D0V1W1X1X1X1Y1V6D0D2

ZZZZZZZZZZZZZZZZZZZZZZZZZZZZZZZZZZZZZZZZZZZZZZZZZZZZZZZZZZZZ
100/100
0

0

0

0

0

0

14/
1000/200/
qdqdqzdzq/