1
ZZZZZZZZZZZZZZZZZZZZZZZZZZZZZZZZZZZZZZB0B3ZZZZZZZZZZZZZZZZZZ

ZZZZZZZZZZZZZZZZZZZZZZZZZZZZZZZZZZZZZZC0C3ZZZZZZZZZZZZZZZZZZ

ZZZZZZZZZZZZZZZZZZZZZZZZZZZZZZZZZZZZZZE0E3ZZZZZZZZZZZZZZZZZZ

ZZZZZZZZZZZZZZZZZZZZZZZZZZZZZZZZZZZZZZZZZZZZZZZZZZZZZZZZZZZZ

ZZZZZZZZZZZZZZZZZZZZZZZZZZZZZZZZZZZZZZZZZZZZZZZZZZZZZZZZZZZZ

ZZZZZZZZZZZZA4ZZZZZZZZZZZZZZA0A1A2A1A2A3ZZZZZZZZZZZZZZZZZZZZ

ZZZZZZZZZZZZZZZZZZZZZZA0A3ZZZZZZZZZZZZZZZZZZZZZZZZZZZZZZA0A1

ZZZZZZZZZZB4ZZZZZZZZZZZZZZZZZZZZZZZZZZZZZZZZZZZZZZZZZZZZZZZZ

ZZZZZZZZB0C3ZZZZZZZZZZZZZZZZZZZZZZZZZZZZZZZZZZZZZZA0A3ZZZZZZ

ZZZZZZB0C1C3ZZZZZZZZZZZZZZZZZZZZZZZZZZZZZZZZZZZZZZZZZZZZZZZZ

ZZZZA4ZZZZZZZZZZZZZZZZZZZZZZZZZZZZZZZZB0B3ZZZZZZZZZZZZZZZZZZ

ZZZZZZZZZZZZZZZZZZZZZZZZZZZZZZZZZZZZZZC0C3ZZZZZZZZZZZZZZZZZZ

ZZZZZZZZZZZZZZZZZZZZZZZZZZZZZZZZZZB0B2C5C3ZZZZZZZZZZZZZZZZZZ

ZZZZZZZZZZZZZZZZZZZZZZZZZZZZZZZZZZC0C2C1C3ZZZZZZZZZZZZZZZZZZ

B1B2B3ZZZZZZB4ZZZZZZZZB0B1B2B1B2B1C5D2C2C3ZZZZZZZZZZZZZZZZZZ

C2C1V0W0X0Y0U0W0X0X0Y0V5C1D0D1D2D0D1C2C1V0W0X0X0X0X0X0X0X0X0

ZZZZZZZZZZZZZZZZZZZZZZZZZZZZZZZZZZZZZZZZZZZZZZZZZZZZZZZZZZZZ
100/800
1
690/880/690/990/
1
1230/600/5000/-60/800/118/30/P1/
1
1200/180/
0

0

0

555/
1760/210/
 /