1
ZZZZZZZZZZZZZZZZZZZZZZZZZZZZZZZZZZZZZZZZZZZZZZZZZZZZZZZZZZZZ

ZZZZZZZZZZZZZZZZZZZZZZZZZZZZZZZZZZZZZZZZZZZZZZZZZZZZZZZZZZZZ

ZZZZZZZZZZZZZZZZZZZZZZZZZZZZZZZZZZZZZZZZZZZZZZZZZZZZZZZZZZZZ

ZZZZZZZZZZZZZZZZZZZZZZZZZZZZZZZZZZZZZZZZZZZZZZZZZZZZZZZZZZZZ

ZZZZZZZZZZZZZZZZZZZZZZZZZZZZZZZZZZZZZZZZZZZZZZZZZZZZZZZZZZZZ

ZZZZZZZZZZZZZZZZZZZZZZZZZZZZZZZZZZZZZZZZZZZZZZZZZZZZZZZZZZZZ

B1B2B3ZZZZZZZZZZZZZZZZZZZZZZZZZZZZZZZZZZB4ZZZZZZZZZZZZB0B2B1

D0C2C3ZZZZZZZZZZZZZZZZZZZZZZZZZZZZZZZZZZC0B2B3ZZZZZZZZC0C1C2

D0C1C3ZZZZZZZZZZZZZZZZZZZZZZZZZZZZZZZZZZC0C1C3ZZZZZZZZC0C2D0

C2C1C3ZZB0Q2Q3P2P1P2Q0Q1B1B1B2B1B2B3ZZZZC0D1C3ZZB0B1B2C5C1D1

D2C2C3ZZC0C3ZZZZZZZZZZC0C1C2C1C1C2C3ZZZZC0C2C3ZZC0C2D0C1C2D0

C1D1C3ZZC0C3ZZZZZZZZZZC0C2D0D1C1C2C3ZZZZC0D2C3ZZC0C1D1D2D2D1

D2D0V0W0V5V0W0X0X0X0Y0V5D0D2D1D2C1V0W0Y0V5D2V0X0V5D0D2D1C1D2

D1C1V1W1V6V1W1X1X1X1Y1V6C1D1D2D2D0V1W1Y1V6D1V1X1V6D1D2D2D1C2

D2C2V2W2V7V2W2X2X2X2Y2V7D0D2D2C1D1V2W2Y2V7C2V2X2V7C2D0D2D2D1

D1C2V3W3V8V3W3X3X3X3Y3V8C2D0D1D2C1V3W3Y3V8C1V3X3V8D0D1D2C1D0

ZZZZZZZZZZZZZZZZZZZZZZZZZZZZZZZZZZZZZZZZZZZZZZZZZZZZZZZZZZZZ
100/284
1
1024/560/256/1090/
1
110/350/3000/1100/500/128/48/P1/
1
1600/450/
0

0

2
tree/800/200/+bush/700/480/
111/
1720/228/
 /