1
ZZZZZZZZZZZZZZZZZZZZZZZZZZZZZZZZZZZZZZZZZZZZZZZZZZZZZZZZZZZZ

ZZZZZZZZZZZZZZZZZZZZZZZZZZZZZZZZZZZZZZZZZZZZZZZZZZZZZZZZZZZZ

ZZZZZZZZZZZZZZZZZZZZZZZZZZZZZZZZZZZZZZZZZZZZZZZZZZZZZZZZZZZZ

ZZZZZZZZZZZZZZZZZZZZZZZZZZZZZZZZZZZZZZZZZZZZZZZZZZZZZZZZZZZZ

ZZZZZZZZZZZZZZZZZZZZZZZZZZZZZZZZZZZZZZZZZZZZZZZZZZZZZZZZZZZZ

ZZZZZZZZZZZZZZZZZZZZZZZZZZZZZZZZZZZZZZZZZZZZZZZZZZZZZZZZZZZZ

ZZZZZZZZZZZZZZZZZZZZZZZZZZZZZZZZZZZZZZZZZZZZZZZZZZZZZZZZZZZZ

ZZZZZZZZZZZZZZZZZZZZZZZZZZZZZZZZZZZZZZZZZZZZZZZZZZZZZZZZZZZZ

ZZZZZZZZZZZZZZZZZZZZZZZZZZZZZZZZZZZZZZB0B1B2B3ZZZZZZZZZZB0B1

ZZZZZZZZZZZZZZZZZZZZZZZZZZZZZZZZZZZZZZC0C1D0C3ZZZZZZZZZZE0C7

B1B2B3ZZZZZZZZZZZZZZZZZZZZZZB0B1B2B1B2C5C2D1C3ZZZZZZZZZZZZC0

C1C2C3ZZZZZZZZZZZZZZZZZZZZZZC0D0D1D2D2D1D2D0C3ZZZZZZZZZZZZC0

D0C1C3ZZZZZZZZZZZZB0B1B2B1B2C5C2D1C8E7E6C7D0C3ZZZZZZZZZZZZC0

D1C2C3ZZZZZZZZZZZZC0C1C2C1D1D0C8E6E8D4F2E5C7C3ZZZZZZZZZZZZC0

D2D1C6B1B2B1B2B1B2C5C2D1D0C8E6E8F2F1D3D4F1C0V1W0X0X0X0X0Y0V5

D2D1C1C2D1D2D2D2D1D0D0D1C2C3F1D4D3D3D4F1F2C0V2W1X1X1X1X1Y1V6

ZZZZZZZZZZZZZZZZZZZZZZZZZZZZZZZZZZZZZZZZZZZZZZZZZZZZZZZZZZZZ
100/400
3
290/880/190/470/+600/750/565/825/+950/620/895/1130/
1
100/600/5000/1630/530/128/48/P1/
0

0

0

1
tree/1200/135/
444/
1750/350/
 /