1
ZZZZZZZZZZZZZZZZZZZZZZZZZZZZZZZZZZZZZZZZZZZZZZZZZZZZZZZZZZZZ

ZZZZZZZZZZZZZZZZZZZZZZZZZZZZZZZZZZZZZZZZZZZZZZZZZZZZZZZZZZZZ

ZZZZZZZZZZZZZZZZZZZZZZZZZZZZZZZZZZZZZZZZZZZZZZZZZZZZZZZZZZZZ

ZZZZZZZZZZZZZZZZZZZZB0B1B3ZZZZZZZZZZZZZZZZZZZZZZZZZZZZZZZZZZ

ZZZZZZZZZZZZZZZZA0A1C5C1C3ZZZZA4ZZZZZZZZZZZZZZZZZZZZZZZZZZZZ

ZZZZZZZZZZZZZZZZZZZZC0E2E3ZZZZZZZZZZZZZZZZZZZZS1ZZZZZZZZZZZZ

ZZZZZZZZZZZZZZZZZZZZE4ZZZZZZZZZZZZA4ZZZZZZA0A2RBA3ZZZZZZZZZZ

ZZZZZZZZZZZZZZZZZZZZZZZZZZZZZZZZZZZZZZZZZZZZZZZZZZZZZZZZZZZZ

ZZZZZZZZZZZZZZZZZZZZZZZZZZZZZZZZZZZZZZZZZZZZZZZZZZZZZZB0B1B2

B1B3ZZZZZZZZZZZZZZZZZZZZZZZZZZZZZZZZZZZZZZZZZZZZZZZZZZE0C7C2

C1C6B2A3ZZZZZZZZZZZZZZZZZZZZZZZZZZZZZZZZZZZZZZZZZZZZZZZZC0C7

C2D0C3ZZZZZZZZZZZZZZZZZZZZZZZZZZZZZZZZZZZZZZZZZZZZZZZZZZE0C1

C1D1C3ZZZZZZZZZZZZZZZZB0B1B2B1B2B3ZZZZZZZZZZZZZZZZZZZZZZZZC0

C2D0C3ZZZZZZA0B2B3ZZZZC0C1C2C1C2C3ZZZZZZZZZZZZZZZZZZZZZZZZC0

D1C1C6B3ZZZZZZC0C3ZZZZC0C2D0D1D0C6B1B3ZZZZZZZZZZZZZZZZZZZZC0

D0C1C2V0W0X0Y0V5V0W0X0V5C1D1D0D2D1C1V0X0X0X0X0X0X0X0X0X0Y0V5

ZZZZZZZZZZZZZZZZZZZZZZZZZZZZZZZZZZZZZZZZZZZZZZZZZZZZZZZZZZZZ
100/100
1
700/750/700/1000/
1
190/865/5000/1200/670/374/48/P5/
0

0

0

0

10/
650/30/
 /