1
ZZZZZZZZZZZZZZZZZZZZZZZZZZZZZZZZZZZZZZZZZZZZZZZZZZZZZZZZZZZZ

ZZZZZZZZZZZZZZZZZZZZZZZZZZZZZZZZZZZZZZZZZZZZZZZZZZZZZZZZZZZZ

ZZZZZZZZZZZZZZZZZZZZZZZZZZZZZZZZZZZZZZZZZZZZZZZZZZZZZZZZZZZZ

ZZZZZZZZZZZZA0A5CAB2B1B3ZZZZZZZZZZZZZZZZZZZZZZZZZZZZZZZZZZZZ

ZZZZZZZZZZZZZZZZE0C7D0C6B3ZZZZZZZZZZZZZZZZZZZZZZZZZZZZZZZZZZ

ZZZZZZZZZZZZZZZZZZC0D2C2C6B1B2B1B3S1ZZZZZZZZZZZZZZZZZZZZZZZZ

ZZZZZZZZZZZZZZZZZZE5E7E6E7E6E7E6CLRBA1A2A3ZZZZZZZZZZZZZZZZZZ

ZZZZZZZZZZZZZZZZZZF0F2F1F2F1G1G1G1F7F1F2F3ZZZZZZZZZZZZZZZZZZ

ZZZZZZZZZZZZZZZZZZF0D3F8G1G3ZZZZZZG0F7D3F3ZZZZZZZZZZP0P1Q1B1

B1B3ZZZZZZZZZZZZZZG0F9G3ZZZZZZZZZZZZG0F7F3ZZZZZZZZZZZZZZC0C2

C1C3ZZZZZZZZZZZZZZZZG4ZZZZZZZZZZZZZZZZF0F3ZZZZZZB4ZZZZZZC0D0

C2C6B3ZZZZZZZZZZZZZZZZZZZZZZZZZZZZZZZZF0F3ZZZZB0C3S1ZZB0C5C1

D1D0C6B1B2B1B2B1B2B1B3ZZZZZZZZZZZZZZZZB0B7B1B2C5C6R1B2C5C2D0

D2C1D2D2C2D1D2D0D1C1V0W0X0X0X0X0X0X0Y0V5C2C1D0D2D1C1D2D2D0D2

D2D2D2D1C1D2D2D2D0C2V1W1X1X1X1X1X1X1Y1V6C1D0D2D2D2D1C1D2D2D2

D2D1D2D0D1D2D2D2D2C1V2W2X2X2X2X2X2X2Y2V7C2D2D1D2D2D2D0C1D2D1

ZZZZZZZZZZZZZZZZZZZZZZZZZZZZZZZZZZZZZZZZZZZZZZZZZZZZZZZZZZZZ
100/300
0

0

2
1520/235/+1520/160/
0

0

2
machine01/1530/60/+machine02/150/45/
999/
2200/150/
 /