1
ZZZZZZZZZZZZZZZZZZZZZZZZZZZZZZZZZZZZZZZZZZZZZZZZZZZZZZZZZZZZ

ZZZZZZZZZZZZZZZZZZZZZZZZZZZZZZZZZZZZZZZZZZZZZZZZZZZZZZZZZZZZ

ZZZZZZZZZZZZZZZZZZZZZZZZZZZZZZZZZZZZZZZZZZZZZZZZZZZZZZZZZZZZ

ZZZZZZZZZZZZZZZZZZZZZZZZZZZZZZZZZZZZZZZZZZZZZZZZZZZZZZZZZZZZ

ZZZZZZZZZZZZZZZZZZZZZZZZZZZZZZZZZZZZZZZZZZS1ZZZZZZZZZZZZZZZZ

ZZZZZZZZZZZZZZZZZZZZZZZZZZZZZZZZZZZZZZZZA0R1A3ZZZZZZZZZZZZZZ

B1B2A3ZZZZZZZZZZZZZZZZZZZZZZZZZZZZZZZZZZZZC4ZZZZZZZZZZZZZZZZ

E1E3ZZZZZZZZZZZZZZZZB0B1B1B3ZZZZZZZZZZZZS0C4ZZZZZZZZZZZZZZZZ

ZZZZZZZZZZZZZZZZZZZZE0E1C1C3ZZZZZZZZZZZZRAE3ZZZZZZZZZZZZZZZZ

ZZZZZZZZB0B1B2B3ZZZZZZZZC0C3ZZZZZZZZZZZZZZZZZZZZZZZZZZZZZZZZ

ZZZZZZZZC0C2D0E3ZZZZZZZZC0C3ZZZZZZZZZZZZZZZZZZB4S1ZZZZZZZZZZ

ZZZZZZZZE0E7C3ZZZZZZZZZZC0C6B2B1B2A1A2B3ZZZZZZE0RBA3ZZZZZZZZ

ZZZZZZZZZZZZC4ZZZZZZZZZZC4F1F2C0E8F2F1C4ZZZZZZZZZZZZZZZZZZZZ

ZZZZZZZZZZZZC4ZZZZZZB0B1C3D3C0C3F1D4D3C4ZZZZZZZZZZZZZZA0B1B2

ZZZZZZZZB0B1CFB3ZZZZC0D0D1D4C0C3F2D3D4C4ZZZZZZZZZZZZZZZZE0E2

ZZZZZZZZC0C2C1C3ZZZZC0C1C2C1C2C2C1C2C1C3ZZZZZZZZZZZZZZZZZZZZ

ZZZZZZZZZZZZZZZZZZZZZZZZZZZZZZZZZZZZZZZZZZZZZZZZZZZZZZZZZZZZ
100/100
0

1
450/860/3000/1050/420/128/48/P1/
0

0

2
520/500/128/750/1/P1/+3000/100/128/800/0/P1/
0

13/
1750/680/
 /