1
ZZZZZZZZZZZZZZZZZZZZZZZZZZZZZZZZZZZZZZZZZZZZZZZZZZZZZZZZZZZZ

ZZZZZZZZZZZZZZZZZZZZZZZZZZZZZZZZZZZZZZZZZZZZZZZZZZZZZZZZZZZZ

ZZZZZZZZZZZZZZZZZZZZZZZZZZZZZZZZZZZZZZZZZZZZZZZZZZZZZZZZZZZZ

ZZZZZZZZZZZZZZZZZZZZZZZZZZZZZZZZZZZZZZZZZZZZZZZZZZZZZZZZZZZZ

ZZZZZZZZZZZZZZZZZZZZZZZZZZB0B1B3ZZZZZZA4ZZZZZZZZZZZZZZZZB0B1

B1B2B1A3ZZZZZZZZA0B1B2B1B2C5C8E3ZZZZZZZZZZZZZZS4ZZZZB0B1C1C2

C8E1E3ZZZZZZZZZZZZE0C7C1D1C2C3ZZZZZZZZZZZZZZZZR6ZZS0C0C1D1D2

E3ZZZZZZZZZZZZZZZZZZE0C7D2C1C3ZZZZZZZZZZZZZZZZC4ZZR0C5C1D0D2

ZZZZZZZZZZZZZZZZZZZZZZC0C1C2C3ZZZZZZZZZZZZB0B1C3ZZE0E1C7C1D0

ZZZZZZZZZZZZB0B3S0S1S2C0C2C1C3S0S1S1S1S1S2C0C8E3ZZZZZZC0C2D1

ZZZZZZZZB0A1E6E7RBRCRBE1E2E1E2RBRCRBRCRBRCE1E3ZZZZZZZZE0E1C2

ZZZZZZZZC4F1F2F1F2F1F2F1F2F3ZZZZZZZZZZZZZZZZZZZZZZZZZZZZZZC0

ZZZZZZZZC4F1F2D4D3D4D3D4F8G3ZZZZZZZZZZZZZZZZZZZZZZZZZZZZZZE0

ZZZZZZB0C3F1D4D3D4D3D4F1F3ZZZZZZZZZZZZZZZZZZZZZZZZZZZZZZZZZZ

ZZZZZZC0C6B6B7B8F1F2F1F2F3ZZB4ZZZZZZZZZZZZZZZZZZZZZZZZZZZZZZ

W0X0Y0V5C1C2C1C6B6B7B6B7B6B2V0W0X0X0X0X0X0X0X0X0X0X0X0X0X0Y0

ZZZZZZZZZZZZZZZZZZZZZZZZZZZZZZZZZZZZZZZZZZZZZZZZZZZZZZZZZZZZ
500/200
1
510/945/510/800/
0

0

0

1
1000/870/128/1600/0/P1/
2
tronc/650/265/+stoneB/400/520/
888/
320/730/
 /