1
ZZZZZZZZZZZZZZZZZZZZZZZZZZZZZZZZZZZZZZZZZZZZZZZZZZZZZZZZZZZZ

ZZZZZZZZZZZZZZZZZZZZZZZZZZZZZZZZZZZZZZZZZZZZZZZZZZZZZZZZZZZZ

ZZZZZZZZZZZZZZZZZZZZZZZZZZZZZZZZZZZZZZZZZZZZZZZZZZZZZZZZZZZZ

ZZZZZZZZZZZZZZZZZZZZZZZZZZZZZZZZZZZZZZZZZZZZZZZZZZZZZZZZZZZZ

ZZZZZZZZZZZZZZZZZZZZZZZZZZZZZZZZZZZZZZZZZZZZZZZZZZZZS1ZZZZZZ

ZZZZZZZZZZZZZZZZZZZZZZZZZZZZZZZZZZZZZZZZZZZZZZA0A1B1R1B2B1B2

ZZZZZZZZZZZZZZZZZZZZZZZZZZZZZZZZZZZZZZZZZZZZZZZZZZE0E1E2C7C2

B2B3ZZZZZZZZZZZZZZZZZZZZZZZZZZS1ZZZZZZZZZZZZZZZZZZZZZZZZE0C7

C2C3S1ZZZZZZZZZZZZZZZZZZZZZZB0R1A2A3ZZZZZZZZZZZZZZZZZZZZZZC0

C1C6R1B3ZZZZZZZZZZZZZZZZZZZZC0E3ZZZZZZZZZZZZZZZZZZZZZZZZZZC0

C2C1C2C3ZZZZZZS1ZZS1ZZZZZZZZE4ZZZZZZZZZZZZZZZZZZZZZZZZZZZZC0

C1D0C2C3ZZZZA0RBA1R1B3ZZZZZZZZZZZZZZZZZZZZZZZZZZZZZZZZB0B1C1

C2C1D0C6B3ZZZZZZZZE0E3ZZZZZZZZZZZZZZZZZZZZS0S1S2ZZZZS2C0C2C1

C1D0D1C2C3ZZZZZZZZZZZZZZZZZZZZZZZZZZZZZZZZR0R1R2B1B2R2C5C1C2

C2C1D0C2V0W0X0X0X0X0X0X0X0X0X0X0X0X0X0X0Y0V5C1C2C1C2D1D0C2C1

C1C1D0C2V0W1X1X1X1X1X1X1X1X1X1X1X1X1X1X1Y1V6C2C1D1D0D1D0D2D2

ZZZZZZZZZZZZZZZZZZZZZZZZZZZZZZZZZZZZZZZZZZZZZZZZZZZZZZZZZZZZ
100/100
0

0

0

1
1535/335/8/L5/
2
750/400/128/800/1/P1/+3000/100/128/800/0/P1/
0

11/
1720/160/
 /