1
ZZZZZZZZZZZZZZZZZZZZZZZZZZZZZZZZZZZZZZZZZZZZZZZZZZZZZZZZZZZZ

ZZZZZZZZZZZZZZZZZZZZZZZZZZZZZZZZZZZZZZZZZZZZZZZZZZZZZZZZZZZZ

ZZZZZZZZZZZZZZZZZZZZZZZZZZZZZZZZZZZZZZZZZZZZZZZZZZZZZZZZZZZZ

ZZZZZZZZZZZZZZZZZZZZZZZZZZZZZZZZZZZZZZZZZZZZZZZZZZZZZZZZZZZZ

ZZZZZZZZZZZZZZZZZZZZZZZZZZZZZZZZZZZZZZZZZZZZZZZZZZZZZZZZZZZZ

ZZZZZZZZZZZZZZZZZZZZZZZZZZZZZZZZZZZZZZZZZZZZZZZZZZZZZZB0B1B2

ZZZZZZZZZZZZZZZZZZZZZZZZZZZZZZZZZZZZZZZZZZZZZZZZZZZZZZC0C1C2

ZZZZZZZZZZA0A1A2B3ZZZZZZZZZZZZZZZZZZZZZZZZZZZZZZZZB0B1C5C2C1

ZZZZZZZZZZZZG0F7CHA1A2CAB3ZZZZZZZZZZB4ZZZZZZZZZZZZC0C1C2D1D0

B1B2B3ZZZZZZZZF0F1F2F1E5C3ZZZZZZZZZZC0B1B2B1B2B1B2C5C2D1D0D2

C1C2C3ZZZZZZZZF0D3F1D4F1C4ZZZZZZZZZZC0C1C2C1C2D1D0D1D2D2D1D2

D0C1C6B1B2B1B3F1D3D4F2H0H6ZZZZZZZZZZC0C2C1D0D2D1D1D2D0D1D0D1

D1C2C1C2C1C2C3F2F1F2F2C0C3ZZZZZZZZZZC0C1C2C1D0D1D0D2D2D0D1D0

D2D1D0D1C2C1C6B6B7B6B7C5V0W0X0X0X0Y0V5C2C1D1D0D2D2D1D2D1D0D1

D2D2D1D0D1D0D2D1C1C2C1C2V1W1X1X1X1Y1V6C1C2C1C2D1D0D0D2D2D2D1

D1D2D2D1D0D1D0D2D2D1C2C1V2W2X2X2X2Y2V7C2C1D0D0D1D2D2D1D2D0D2

ZZZZZZZZZZZZZZZZZZZZZZZZZZZZZZZZZZZZZZZZZZZZZZZZZZZZZZZZZZZZ
100/300
2
190/695/190/387/+1215/560/1215/1500/
1
534/800/5000/910/550/463/30/P1/
0

0

0

1
tree/280/70/
666/
1760/150/
 /